1111111111111111111
10C0CCCC0CCCC0CCCC1
1CC0000C0000C0C00C1
10C000000000C0000C1
10C000000000C0000C1
10C0CCC00CCCC0000C1
10C0000C0000C0000C1
10C0000C0000C0000C1
10C01P1C0000C0000C1
10C0CCCC0CCCC0000C1
1111111111111111111
