1111111111111111111111111111111111111
1C00000000000000000000000000000000001
100C000000000000000000000000000000001
1000000000000000000000000000000000001
1000000000000000000000000000000000001
1000000000000000000000000000000000001
1000000000000000000000000000000000001
100000000000000000000000000000000C001
1000000000000000000000000000000000001
1000000000000000000000000000000000001
100000000001000000000000000000E000001
10000000001P0000000000000000000000001
1000000000010000000000000000000000001
1000000000000000000000000000000000001
1000000000000000000000000000000000001
1000000000000000000000000000000000001
1111111111111111111111111111111111111
