11111111111111111111
1     CC    CCC    1
1    C C   C   C   1
1   C  C       C   1
1  C   C       C   1
1  CCCCCC    C    1
1      C     C     1
1      C    C    C 1
1   P  C  CCCCCCCC 1
11111111111111111111
