1111111111111111111111111111111111111
1C00000000000000000000000000000000001
1000000000000000000000000000000000001
1000000000000000000000000000000000001
1000000000000000000000000000000000001
1000000000000C00000000000000000000001
10000000000000000000C0000000000000001
100000000000000000000000000000000C001
1001C000000000000C00000C0000000000001
1000000000000000000000000000000000001
100000000000000C00000000000000E000001
10000000001P0000000000000000000000001
10000000000100000000010011C00C0000001
1000000000000000000000000000000000001
100000C0000000000000C0000000000000001
1000000000000000000000000000000000001
1111111111111111111111111111111111111


